OOOOOOOOOOOOO   OOOOOO
OOOOOOOOOOOOO   OOOOOO
OO    126 >>    OOOOOO
OO   OOOOOOOOOOOOOOOOO
OO   OOOOOOOOOOOOOOOOO
OO   OOOOOOOOOOOOOOOOO
OO   OOO   OOOOOOOOOOO
OO   OOO   OOOOOOOOOOO
OO   OOO   OOOOOOOOOOO
OO         OOOOOOOOOOO
OOOOOOOO   OOOOOOOOOOO
OOOOOOOO   OOOOOOOOOOO
OOOOOOOO   OOOOOOOOOOO
OOOOOOOO   OOOOOOOOOOO
<< 436     OOOOOOOOOOO
OOOOOOOO   OOOOOOOOOOO
OOOOOOOO       231 >> 
OOOOOOOO   OOOOOOOOOOO
OOOOOOOO   OOOOOOOOOOO
